3 40 20

0 0 0 0 0 0 0 0 0 0 0 0 0 0 0 0 0 0 0 787 787 787 787 787 787 787 787 787 787 787 787 787 787 787 787 787 787 787 787 787 
0 0 0 0 0 0 0 0 0 0 0 0 0 0 0 0 0 0 0 787 787 0 0 0 0 0 0 0 0 0 0 0 0 0 0 0 0 0 787 787 
787 787 787 787 787 787 787 787 787 787 0 0 0 0 0 0 0 0 0 787 0 0 0 0 0 0 0 0 0 0 0 0 0 0 0 0 0 0 0 787 
787 787 0 0 0 0 0 0 787 787 0 0 0 0 0 0 0 0 0 787 0 0 0 0 0 0 0 0 0 0 0 0 0 0 0 0 0 0 0 787 
787 0 0 0 0 0 0 0 0 787 0 0 0 0 0 0 0 0 0 787 0 0 0 0 0 0 0 0 0 0 0 0 0 0 0 0 0 0 0 787 
787 0 0 0 0 0 0 0 0 787 0 0 0 0 0 0 0 0 0 787 0 0 0 0 0 0 0 0 0 0 0 0 0 0 0 0 0 0 0 787 
787 0 0 0 0 0 0 0 0 787 0 0 0 0 0 0 0 0 0 787 0 0 0 0 0 0 0 0 0 0 0 0 0 0 0 0 0 0 0 787 
787 0 0 0 0 0 0 0 0 787 0 0 0 0 0 0 0 0 0 787 0 0 0 0 0 0 0 0 0 0 0 0 0 0 0 0 0 0 0 787 
787 0 0 0 0 0 0 0 0 787 0 0 0 0 0 0 0 0 0 787 0 0 0 0 0 0 0 0 0 0 0 0 0 0 0 0 0 0 0 787 
787 787 787 787 0 0 787 787 787 787 787 787 787 787 787 787 787 787 787 787 0 0 0 0 0 0 0 0 0 0 0 0 0 0 0 0 0 0 0 787 
787 787 0 0 0 0 0 0 0 0 0 0 0 0 0 0 0 0 787 787 0 0 0 0 0 0 0 0 0 0 0 0 0 0 0 0 0 0 0 787 
787 0 0 0 0 0 0 0 0 0 0 0 0 0 0 0 0 0 0 787 0 0 0 0 0 0 0 0 0 0 0 0 0 0 0 0 0 0 0 787 
787 0 0 0 0 0 0 0 0 0 0 0 0 0 0 0 0 0 0 787 0 0 0 0 0 0 0 0 0 0 0 0 0 0 0 0 0 0 0 787 
787 0 0 0 0 0 0 0 0 0 0 0 0 0 0 0 0 0 0 787 0 0 0 0 0 0 0 0 0 0 0 0 0 0 0 0 0 0 0 787 
787 0 0 0 0 0 0 0 0 0 0 0 0 0 0 0 0 0 0 0 0 0 0 0 0 0 0 0 0 0 0 0 0 0 0 0 0 0 0 787 
787 0 0 0 0 0 0 0 0 0 0 0 0 0 0 0 0 0 0 0 0 0 0 0 0 0 0 0 0 0 0 0 0 0 0 0 0 0 0 787 
787 787 0 0 0 0 0 0 0 0 0 0 0 0 0 0 0 0 0 787 0 0 0 0 0 0 0 0 0 0 0 0 0 0 0 0 0 0 0 787 
0 787 787 0 0 0 0 0 0 0 0 0 0 0 0 0 0 0 0 787 0 0 0 0 0 0 0 0 0 0 0 0 0 0 0 0 0 0 0 787 
0 0 787 787 0 0 0 0 0 0 0 0 0 0 0 0 0 0 0 787 0 0 0 0 0 0 0 0 0 0 0 0 0 0 0 0 0 0 0 787 
0 0 0 787 787 787 787 787 787 787 787 787 787 787 787 787 787 787 787 787 787 787 787 787 787 787 787 787 787 787 787 787 787 787 787 787 787 787 787 787


0 0 0 0 0 0 0 0 0 0 1 1 1 1 1 1 1 1 1 35 35 35 35 35 35 35 35 35 35 35 35 35 35 35 35 35 35 35 35 35 
0 0 0 0 0 0 0 0 0 0 1 1 1 1 1 1 1 1 1 35 163 163 163 163 163 163 163 163 163 163 163 163 163 163 163 163 163 163 163 35 
35 35 35 35 35 35 35 35 35 35 1 1 1 1 1 1 1 1 1 35 163 163 163 163 163 163 163 163 163 163 163 163 163 163 163 163 163 163 163 35 
35 163 163 163 163 163 163 163 163 35 1 1 1 1 1 1 1 1 1 35 163 163 163 163 163 163 163 163 163 163 163 163 163 163 163 163 163 163 163 35 
35 163 163 163 163 163 163 163 163 35 1 1 1 1 1 1 1 1 1 35 163 163 163 163 163 163 163 163 163 163 163 163 163 163 163 163 163 163 163 35 
35 163 163 163 163 163 163 163 163 35 1 1 1 1 1 1 1 1 1 35 163 163 163 163 163 163 163 163 163 163 163 163 163 163 163 163 163 163 163 35 
35 163 163 163 163 163 163 163 163 35 1 1 1 1 1 1 1 1 1 35 163 163 163 163 163 163 163 163 163 163 163 163 163 163 163 163 163 163 163 35 
35 163 163 163 163 163 163 163 163 35 1 1 1 1 1 1 1 1 1 35 163 163 163 163 163 163 163 163 163 163 163 163 163 163 163 163 163 163 163 35 
35 163 163 163 163 163 163 163 163 35 1 1 1 1 1 1 1 1 1 35 163 163 163 163 163 163 163 163 163 163 163 163 163 163 163 163 163 163 163 35 
35 35 35 35 163 163 35 35 35 35 35 35 35 35 35 35 35 35 35 35 163 163 163 163 163 163 163 163 163 163 163 163 163 163 163 163 163 163 163 35 
35 163 163 163 163 163 163 163 163 163 163 163 163 163 163 163 163 163 163 35 163 163 163 163 163 163 163 163 163 163 163 163 163 163 163 163 163 163 163 35 
35 163 163 163 163 163 163 163 163 163 163 163 163 163 163 163 163 163 163 35 163 163 163 163 163 163 163 163 163 163 163 163 163 163 163 163 163 163 163 35 
35 163 163 163 163 163 163 163 163 163 163 163 163 163 163 163 163 163 163 35 163 163 163 163 163 163 163 163 163 163 163 163 163 163 163 163 163 163 163 35 
35 163 163 163 163 163 163 163 163 163 163 163 163 163 163 163 163 163 163 35 163 163 163 163 163 163 163 163 163 163 163 163 163 163 163 163 163 163 163 35 
35 163 163 163 163 163 163 163 163 163 163 163 163 163 163 163 163 163 163 163 163 163 163 163 163 163 163 163 163 163 163 163 163 163 163 163 163 163 163 35 
35 163 163 163 163 163 163 163 163 163 163 163 163 163 163 163 163 163 163 163 163 163 163 163 163 163 163 163 163 163 163 163 163 163 163 163 163 163 163 35 
35 35 163 163 163 163 163 163 163 163 163 163 163 163 163 163 163 163 163 35 163 163 163 163 163 163 163 163 163 163 163 163 163 163 163 163 163 163 163 35 
35 35 35 163 163 163 163 163 163 163 163 163 163 163 163 163 163 163 163 35 163 163 163 163 163 163 163 163 163 163 163 163 163 163 163 163 163 163 163 35 
35 35 35 35 163 163 163 163 163 163 163 163 163 163 163 163 163 163 163 35 163 163 163 163 163 163 163 163 163 163 163 163 163 163 163 163 163 163 163 35 
35 35 35 35 35 35 35 35 35 35 35 35 35 35 35 35 35 35 35 35 35 35 35 35 35 35 35 35 35 35 35 35 35 35 35 35 35 35 35 35


0 0 0 418 419 420 421 0 0 0 0 0 0 0 0 0 0 0 0 0 166 0 0 0 0 0 0 0 0 0 0 0 0 0 0 0 0 0 166 0 
227 227 227 450 451 452 453 227 227 227 0 0 0 0 0 0 0 0 0 0 198 0 0 0 0 0 0 0 0 0 0 0 0 0 0 0 0 0 198 0 
0 166 0 482 483 484 485 0 166 0 0 0 0 0 0 0 0 0 0 0 230 0 0 0 0 0 0 0 0 0 0 0 0 0 0 0 0 0 230 0 
0 198 0 0 0 0 0 0 198 0 0 0 0 0 0 0 0 0 0 0 0 0 0 0 0 0 0 0 0 0 0 0 0 0 0 0 0 0 0 0 
0 230 0 0 0 0 0 0 230 0 0 0 0 0 0 0 0 0 0 0 0 0 0 0 0 0 0 0 0 0 0 0 0 0 0 0 0 0 0 0 
0 0 0 0 0 0 0 0 0 0 0 0 0 0 0 0 0 0 0 0 0 0 0 0 0 0 0 0 0 0 0 0 0 0 0 0 0 0 0 0 
0 0 0 0 0 0 0 0 0 0 0 0 0 0 0 0 0 0 0 0 0 0 0 0 0 0 0 0 0 0 0 0 0 0 0 0 0 0 0 0 
0 0 0 0 0 0 0 0 0 0 0 0 0 0 0 0 0 0 0 0 0 0 0 0 0 0 0 0 0 0 0 0 0 0 0 0 0 0 0 0 
0 0 0 0 0 0 0 0 0 0 0 0 0 0 0 0 0 0 0 0 0 0 0 0 0 0 0 0 0 0 0 0 0 0 0 0 0 0 0 0 
0 166 0 0 0 0 0 0 0 0 0 0 0 0 0 0 0 0 166 0 0 0 0 0 0 0 0 0 0 0 0 0 0 0 0 0 0 0 0 0 
0 198 0 0 0 0 0 0 0 0 0 0 0 0 0 0 0 0 198 0 0 0 0 0 0 0 0 0 0 0 0 0 0 0 0 0 0 0 0 0 
0 230 0 0 0 0 0 0 0 0 0 0 0 0 0 0 0 0 230 0 0 0 0 0 0 0 0 0 0 0 0 0 0 0 0 0 0 0 0 0 
0 0 0 0 0 0 0 0 0 0 0 0 0 0 0 0 0 0 0 1 0 0 0 0 0 0 0 0 0 0 0 0 0 0 0 0 0 0 0 0 
0 0 0 0 0 0 0 0 0 0 0 0 0 0 0 0 0 0 0 1 0 0 0 0 0 0 0 0 0 0 0 0 0 0 0 0 0 0 0 0 
0 0 0 0 0 0 0 0 0 0 0 0 0 0 0 0 0 0 0 0 0 0 0 0 0 0 0 0 0 0 0 0 0 0 0 0 0 0 0 0 
0 0 0 0 0 0 0 0 0 0 0 0 0 0 0 0 0 0 0 0 0 0 0 0 0 0 0 0 0 0 0 0 0 0 0 0 0 0 0 0 
0 0 0 0 0 0 0 0 0 0 0 0 0 0 0 0 0 0 0 0 0 0 0 0 0 0 0 0 0 0 0 0 0 0 0 0 0 0 0 0 
0 0 0 0 0 0 0 0 0 0 0 0 0 0 0 0 0 0 0 0 0 0 0 0 0 0 0 0 0 0 0 0 0 0 0 0 0 0 0 0 
0 0 0 0 0 0 0 0 0 0 0 0 0 0 0 0 0 0 0 0 0 0 0 0 0 0 0 0 0 0 0 0 0 0 0 0 0 0 0 0 
0 0 0 0 0 0 0 0 0 0 0 0 0 0 0 0 0 0 0 0 0 0 0 0 0 0 0 0 0 0 0 0 0 0 0 0 0 0 0 0