20 20

1 1 1 1 1 1 1 1 1 419 420 1 1 1 1 1 1 1 1 1 
2 4 3 4 4 2 3 4 450 451 452 453 2 2 2 2 2 2 2 3 
35 36 35 36 36 34 35 36 482 483 484 485 34 34 34 34 34 34 34 35 
130 131 131 131 131 131 131 131 131 131 131 131 131 131 131 131 131 131 131 132 
162 163 163 163 163 163 163 163 163 163 163 163 163 163 163 163 163 163 163 164 
162 163 163 163 163 163 163 163 163 163 163 163 163 163 163 163 163 163 163 164 
162 163 163 163 163 163 163 163 163 163 163 163 163 163 163 163 163 163 163 164 
162 163 163 163 163 163 163 163 163 163 163 163 163 163 163 163 163 163 163 164 
162 163 163 163 163 163 163 163 163 163 163 163 163 163 163 163 163 163 163 164 
162 163 163 163 163 163 163 163 163 163 163 163 163 163 163 163 163 163 163 164 
162 163 163 163 163 163 163 163 163 163 163 163 163 163 163 163 163 163 163 164 
162 163 163 163 163 163 163 163 163 163 163 163 163 163 163 163 163 163 163 164 
162 163 163 163 163 163 163 163 163 163 163 163 163 163 163 163 163 163 163 164 
162 163 163 163 163 163 163 163 163 163 163 163 163 163 163 163 163 163 163 164 
162 163 163 163 163 163 163 163 163 163 163 163 163 163 163 163 163 163 163 164 
162 163 163 163 163 163 163 163 163 163 163 163 163 163 163 163 163 163 163 164 
162 163 163 163 163 163 163 163 163 163 163 163 163 163 163 163 163 163 163 164 
162 163 163 163 163 163 163 163 163 163 163 163 163 163 163 163 163 163 163 164 
162 163 163 163 163 163 163 163 163 163 163 163 163 163 163 163 163 163 163 164 
194 195 195 195 195 195 195 195 195 195 195 195 195 195 195 195 195 195 195 196